# To Outside Entrance
0,0,19,1, 5,19,5,0
0,1,20,1, 5,20,5,0

# To Main 2
0,0,19,11, -1,19,32,0
0,1,20,11, -1,20,32,0
0,0,19,32, -1,19,11,0
0,1,20,32, -1,20,11,0

# To Room <MapName>
0,0,33,1, -1,33,1,0
0,0,33,5, -1,33,5,0
0,0,6,5, -1,6,5,0

# Sunlight Valley
## To Room
0,0,6,1, -1,45,1,0
0,0,45,1, -1,6,1,0
## To Map
0,0,55,4, 7,5,3,0

# To Outside Underground
5,0,4,47, 5,4,1,0