15,0,0,39, 15,0,0,39
41,17,0,39, 41,17,0,39
51,46,0,39, 51,46,0,39
11,0,41,60, 11,0,41,60
18,14,44,57, 18,14,44,57