-1,8,6,2,6,10,10,10,10,10,10,10,10,10,10,6,7
-1,10,6,2,2,10,10,7,10
-1,3,7,5,5,10,10,10,10,10,10,10,10,10,10,10,10,10,10,10,10,10,10,10,10,10,10,10,7,7
-1,4,9,1,1,12
-1,5,10,1,1,12
-1,7,9,1,1,11
-1,8,8,1,1,11
-1,9,7,1,1,12
>
-1,47,0,2,6,10,10,10,10,10,10,10,10,10,10,10,10
-1,49,0,2,5,10,10,10,11,10,11,10,11,10,11
-1,46,1,1,4,10,10,10,10
-1,45,2,1,2,10,10
>